4,5,5,4,5,4,5,4,5,4
4,5,5,4,5,4,5,4,5,4
4,5,5,4,5,4,5,4,5,4
4,5,5,4,5,4,5,4,5,4
4,5,5,4,5,4,5,4,5,4
4,5,5,4,5,4,4,5,4,183
4,5,5,4,5,4,5,4,5,4
4,5,5,4,5,4,6,4,5,4
4,5,5,4,5,4,5,4,5,4
